.........................
..BEEEEEEEEEEEEEEEEEEEEA.
.BEEEEEEEEEEEEEEEEEEEEEA.
D*ooooooooooooooooooooooo
FooBEEEEEEEEEEEEEEEEEEEAo
FoBEEEEEEEEEEEEEEEEEEEEAo
FoDD*oooooooooooooooooooo
FoFFooBEEEEEEEEEEEEEEEEAo
FoFFoBEEEEEEEEEEEEEEEEEAo
FoFFoDD*ooooooooooooooooo
FoFFoFFooBEEEEEEEEEEEEEAo
FoFFoFFoBEEEEEEEEEEEEEEAo
FoFFoFFoDD*oooooooooooooo
FoFFoFFoFFooBEEEEEEEEEEAo
FoFFoFFoFFoBEEEEEEEEEEEAo
FoFFoFFoFFoDD*ooooooooooo
FoFFoFFoFFoFFooBEEEEEEEAo
FoFFoFFoFFoFFoBEEEEEEEEAo
FoFFoFFoFFoFFoDD*oooooooo
FoFFoFFoFFoFFoFFooBEEEEAo
FoFFoFFoFFoFFoFFoBEEEEEAo
FoFFoFFoFFoFFoFFoDD*ooooo
FoCFoCFoCFoCFoCFoCFooBEAo
CooCooCooCooCooCooCooBEAo
oooooooooooooooooooooooou

points 1800
maxsize 22
